10
10
0000000000
0000000000
0000000000
0000X0X000
0000000000
0000XX0000
00000X0000
00X00X0000
00XXXX0000
0000000000