10
10
0000000000
0000000000
0000000000
0000X0X000
0000000000
0000XXX000
00000X0000
00000X0000
00000X0000
0000000000